1111111111
111%111111
11$6df?611
11isxXau11
11G6c6LK11
11ry,.tr11
11KZ666G11
11ionmpu11
1166h66611
1111111111
