1111111111
1114111111
1146df6611
11isxXau11
11G6c6LK11
11ry66tr11
11KZ666G11
11io66pu11
1166h66611
1111111111
