1111111111
1111!w!111
1111!e!111
118zV8xl11
1188118811
119X11c911
118KLGZ811
11C9999v11
118gBb8k11
1111!q!111
1111111111