11111111111
11111111111
11150403111
11105053111
11150523111
11105053111
11150503111
11105053111
11111111111
11111111111